	NO	./textures/sq.xpm
		WE	./textures/door.xpm

			EA	./textures/glass.xpm
																					SO ./textures/logement.xpm
																																																																																							F 130,33,223	
						C 144,42,143

1111
1N01
1111